....................DD
....................DD
....................DD
.S..................DD
DG..................DD
DDGG.........P..P...DD
DDDD................DD
DDDD...............CDD
DDD.................DD
DDD...............GGDD
DDDG...........GGGDDDD
DDDDGGGGGGGGGGGDDDDDDD
DDDDDDDDDDDDDDDDDDDDDD